111111111111111111111111111111111111111111111111111111111111111111111111111111111111111111111111111111111111111111111111111111111111111111111111100000000001111111111111111111111111111111111111111111111111111111111111111111111111111111111111111111111111111111111111111111111111111111111111111111111111
100000000000100000000000000000000000000000000000000000000000000000000000100000000000000000000000000000000001100000000000000000000000000000000000000000000000000000000000000000000001100000000000000000000000000000000000000000000000000000000000000000000000000000000000000000000000000000000001000000000001
100000000000100000000000000000000000000000000000000000000000000000000000100000000000000000000000000000000001100000000000000000000000000000000000000000000000000000000000000000000001100000000000000000000000000000000000000000000000000000000000000000000000000000000000000000000000000000000001000000000001
100000000000100000000000100000000000111111111111111111111111100000000000111111111111111111111111100000000001100000000001111111111111100000000001100000000001111111111111111111111111100000000001111111111111000000000001111111111111111111111111111111111111111111111111111111111111000000000001000000000001
100000000000000000000000100000000000000000000000100000000000100000000000100000000000000000000000000000000001100000000001100000000001100000000001100000000001100000000000000000000001100000000000000000000001000000000000000000000001000000000000000000000001000000000000000000000001000000000001000000000001
100000000000111111111111111111111111100000000000100000000000100000000000100000000000111111111111100000000001100000000001100000000001100000000001100000000001100000000000000000000001111111111111000000000001111111111111000000000001000000000001000000000001000000000001000000000001000000000001000000000001
100000000000100000000000000000000000000000000000100000000000100000000000000000000000100000000000000000000001100000000001100000000001100000000001100000000001100000000001100000000000000000000001100000000000000000000001000000000000000000000001000000000001000000000001000000000001000000000001000000000001
110000000000100000000000000000000000000000000000100000000000100000000000000000000000100000000000000000000001100000000001100000000001100000000001100000000001100000000001100000000000000000000001100000000000000000000001000000000000000000000001000000000001000000000001000000000001000000000001000000000001
111111111111100000000000111111111111111111111111100000000000100000000000111111111111111111111111111111111111100000000001100000000001100000000001111111111111100000000001111111111111000000000001111111111111000000000001111111111111111111111111000000000001000000000001000000000001000000000001000000000001
110000000000000000000000100000000000000000000000100000000000000000000000100000000000000000000000000000000001100000000000000000000001100000000000000000000000000000000001100000000000000000000000000000000001000000000001100000000000000000000000000000000001000000000001000000000001000000000000000000000001
100000000000000000000000100000000000000000000000100000000000000000000000100000000000000000000000000000000001100000000000000000000001100000000000000000000000000000000001100000000000000000000000000000000001000000000001000000000000000000000000000000000001000000000001000000000001000000000000000000000001
100000000000000000000000100000000000000000000000100000000000000000000000100000000000000000000000000000000001100000000000000000000001100000000000000000000000000000000001100000000000000000000000000000000001000000000001000000000000000000000000000000000001000000000001000000000001000000000000000000000001
100000000000100000000000100000000000100000000000111111111111111111111111100000000000111111111111100000000000100000000001111111111111111111111111111111111111100000000001100000000001100000000001111111111111000000000001000000000001111111111111111111111111111111111111000000000001111111111111000000000001
100000000000100000000000100000000000100000000000000000000000000000000000100000000000000000000000100000000000000000000001100000000000000000000000000000000001100000000001100000000001100000000001100000000000000000000001000000000000000000000001000000000000000000000000000000000001000000000000000000000001
100000000000100000000000100000000000110000000000000000000000000000000000100000000000000000000001100000000000000000000001100000000000000000000000000000000001100000000001100000000001100000000001100000000000000000000001100000000000000000000001000000000000000000000000000000000011000000000000000000000011
100000000000100000000000100000000000111111111111111111111111100000000000100000000000111111111111111111111111100000000001100000000000111111111111100000000001111111111111000000000001100000000001100000000001111111111111111111111111000000000001000000000001111111111111111111111111000000000001111111111111
100000000000100000000000100000000000100000000000000000000000100000000000000000000000100000000000000000000001100000000001100000000000000000000001100000000000000000000000000000000001100000000001100000000000000000000000000000000001000000000001000000000000000000000000000000000000000000000000000000000001
100000000000111111111111100000000000100000000000100000000000111111111111111111111111100000000000100000000001111111111111111111111111000000000001111111111111000000000000111111111111111111111111111111111111111111111111000000000001000000000001000000000001111111111111111111111111111111111111111111111111
100000000000000000000000100000000000100000000000100000000000100000000000000000000000000000000000100000000000000000000000000000000000000000000001100000000000000000000001100000000000000000000000000000000001000000000000000000000001000000000001000000000001000000000000000000000001000000000000000000000001
100000000000000000000000100000000000100000000000100000000000100000000000000000000000000000000001100000000000000000000000000000000000000000000001100000000000000000000001100000000000000000000000000000000001000000000000000000000001000000000001000000000001000000000000000000000001000000000000000000000001
10000000000010000000000010000000000010000000000010000000000010000000000011111111111111111111111111111111111111111111111110000000000111111111111111111111111111111111111110000000000100000000000100000000000100000000000111111111111100000000000111111111111100000000000100000000000100000000000100000000000
100000000000100000000000000000000000100000000000100000000000100000000000000000000000000000000000000000000000000000000001100000000001100000000000000000000000000000000000000000000001100000000001100000000001000000000001000000000001000000000000000000000000000000000001000000000000000000000001000000000001
100000000000110000000000000000000000100000000000100000000000100000000000000000000000000000000000000000000000000000000001100000000001100000000000000000000000000000000000000000000001100000000001100000000001000000000001000000000001000000000000000000000000000000000001000000000000000000000011000000000001
100000000000111111111111111111111111100000000000111111111111111111111111111111111111111111111111111111111111100000000000111111111111100000000001111111111111111111111111111111111111100000000001111111111111000000000001000000000001111111111111111111111111111111111111111111111111111111111111000000000001
100000000000000000000000100000000000100000000000000000000000000000000000100000000000000000000000000000000001100000000000000000000000000000000001100000000001100000000000000000000001100000000000000000000001000000000000000000000001000000000000000000000000000000000000000000000001000000000000000000000001
110000000000000000000000100000000000100000000000000000000000000000000000100000000000000000000000000000000001100000000000000000000000000000000001100000000001100000000000000000000001100000000000000000000001100000000000000000000001000000000000000000000000000000000000000000000001000000000000000000000001
111111111111100000000000100000000000100000000000111111111111100000000000100000000000111111111111100000000000111111111111111111111111111111111111000000000001100000000001100000000001111111111111000000000001111111111111000000000001000000000001111111111111111111111111000000000001000000000001000000000001
100000000000100000000000100000000000100000000000100000000000000000000000100000000000100000000000100000000000000000000000000000000000000000000000000000000001100000000001100000000001100000000000000000000001000000000000000000000000000000000001000000000000000000000001000000000001000000000001000000000001
100000000000100000000000100000000000100000000000100000000000000000000000100000000000100000000000100000000000000000000000000000000000000000000000000000000001100000000001100000000001100000000000000000000001000000000000000000000000000000000001000000000000000000000001000000000001000000000001000000000001
100000000000100000000000100000000000100000000000100000000000000000000000100000000000100000000000100000000000000000000000000000000000000000000000000000000001100000000001100000000001100000000000000000000001000000000000000000000000000000000001000000000000000000000001000000000001000000000001000000000001
100000000000100000000000100000000000100000000000100000000000111111111111100000000000100000000000111111111111100000000000111111111111111111111111111111111111100000000001100000000001100000000001111111111111000000000001111111111111111111111111000000000001000000000001111111111111000000000001000000000001
100000000000100000000000100000000000000000000000100000000000000000000000000000000000000000000000100000000001100000000001100000000000000000000000000000000001100000000001100000000001100000000000000000000000000000000001000000000000000000000000000000000001000000000000000000000000000000000001000000000001
100000000000100000000000100000000000000000000000100000000000000000000000000000000000000000000000100000000001100000000001100000000000000000000000000000000001100000000001100000000001100000000000000000000000000000000001000000000000000000000000000000000001000000000000000000000000000000000001000000000001
100000000000100000000000111111111111111111111111111111111111111111111111111111111111100000000000100000000001100000000001100000000000111111111111100000000001100000000001100000000001111111111111111111111111111111111111000000000001111111111111111111111111111111111111111111111111111111111111000000000001
100000000000000000000000100000000000000000000000000000000000100000000000000000000001100000000000000000000001100000000000000000000000000000000001100000000001100000000001100000000000000000000000000000000000000000000001000000000001000000000000000000000000000000000000000000000000000000000011000000000001
100000000000000000000000100000000000000000000000000000000000100000000000000000000000100000000000000000000001100000000000000000000000000000000001100000000001100000000001100000000000000000000000000000000000000000000001000000000001000000000000000000000000000000000000000000000000000000000001000000000001
100000000000111111111111100000000000111111111111100000000000100000000000100000000000111111111111100000000000111111111111111111111111111111111111100000000001100000000001111111111111111111111111111111111111000000000001000000000001111111111111000000000001111111111111111111111111000000000001000000000001
100000000000100000000000000000000000100000000000100000000000000000000000100000000000000000000000100000000000000000000001100000000000000000000001100000000001100000000001100000000000000000000001100000000001000000000001000000000000000000000001000000000000000000000000000000000001000000000001000000000001
100000000000100000000000000000000000100000000000100000000000000000000000100000000000000000000000100000000000000000000001100000000000000000000001100000000001100000000001100000000000000000000001100000000001000000000001000000000000000000000001000000000000000000000000000000000001000000000001000000000001
100000000000100000000000000000000000100000000000100000000000000000000000100000000000000000000000100000000000000000000001100000000000000000000001100000000001100000000001100000000000000000000001100000000001000000000001000000000000000000000001000000000000000000000000000000000001000000000001000000000001
100000000000100000000000111111111111100000000000111111111111111111111111111111111111100000000000111111111111111111111111000000000001100000000000000000000001100000000001100000000001100000000000000000000001000000000001000000000001000000000001000000000001111111111111000000000001000000000001000000000001
100000000000000000000000100000000000000000000000100000000000000000000000000000000000100000000000100000000000000000000000000000000001100000000000000000000001100000000001100000000001100000000000000000000001000000000001000000000001000000000001000000000000000000000001000000000001000000000001000000000001
100000000000000000000000100000000000000000000000100000000000000000000000000000000000100000000000100000000000000000000000000000000001100000000000000000000001100000000001100000000001100000000000000000000001000000000001000000000001000000000001000000000000000000000001000000000001000000000001000000000001
110000000000000000000000100000000000000000000000100000000000000000000000000000000000100000000000100000000000000000000000000000000001100000000000000000000001100000000001100000000001100000000000000000000001000000000001000000000001000000000001000000000000000000000001000000000001000000000001000000000001
111111111111111111111111100000000000111111111111100000000000100000000000111111111111100000000000100000000000111111111111111111111111100000000000111111111111100000000001100000000001111111111111111111111111000000000001111111111111000000000001111111111111000000000001000000000001111111111111000000000001
110000000000000000000000000000000000000000000000000000000000100000000000000000000000000000000000000000000001100000000000000000000000000000000001100000000000000000000001100000000000000000000000000000000000000000000000000000000000000000000001000000000000000000000001000000000000000000000000000000000001
110000000000000000000000000000000000000000000000000000000000100000000000000000000000000000000000000000000001100000000000000000000000000000000001100000000000000000000001100000000000000000000000000000000000000000000000000000000000000000000001000000000000000000000001000000000000000000000000000000000011
111111111111111111111111111111111111111111111111111111111111111111111111111111111111111111111111111111111111111111111111111111111111111111111111100000000001111111111111111111111111111111111111111111111111111111111111111111111111111111111111111111111111111111111111111111111111111111111111111111111111