111111111111111111111111111111111111110000000000000000000000000000000000000000000000000000000000000000000000000000000000
110000000000000000000000000000000000110000000000000000000000000000000000000000000000000000000000000000000000000000000000
110000000000000000000000000000000000110000000000000000000000000000000000000000000000000000000000000000000000000000000000
110000000000000000000000000000000000110000000000000000000000000000000000000000000000000000000000000000000000000000000000
110000000000000000000000000000000000110000000000000000000000000000000000000000000000000000000000000000000000000000000000
110000000000000000000000000000000000110000000000000000000000000000000000000000000000000000000000000000000000000000000000
110000000000000000000000000000000000110000000000000000000000000000000000000000000000000000000000000000000000000000000000
110000000000000000000000000000000000110000000000000000000000000000000000000000000000000000000000000000000000000000000000
11000000000000000000000000000000000011
11000000000000000000000000000000000011
11000000000000000000000000000000000011
11000000000000000000000000000000000011
11000000000000000000000000000000000011
11222222222222222000000000000000000011
11111111111111111000000000000000000011
11000011000000000000000000000000000011
11000011000000000000000000000000000011
11001111110000000000000000000000000011
11000111100000000000000000200000000011
11000011000000000000000002000000000011
11000000000000000000000020000000000011
11000000000000000000000200000000000011
11000000000000000000002000000000000011
11100010000000000000020000000000000011
11010100000000000000000000000000000011
11001000000000000000000000000000000011
11010100000000000000000000000000000011
11100010000000000000000000000000000011
11000000000000000000000000000000000011
11000000000000000000000000000000000011
11000000000000000000000000000000000011
11000000000000000000000000000000000011
11000000000000000000000000000000000011
11000000000000000000000000000000000011
11000000000000000000000000000000000011
11000000000000000000000000000000000011
11000000000000000000000000000000000011
11000000000000000000000000000000000011
11000000000000000000000000000000000011
11000000000000000000000000000000000011
1100000000000000000000000000000000001100000000000000000000000222222
11000020000000000000000000000000000011
1100001000000000000000000000000000001100000000000000000000000000000
11000010000000000000000000000000000011000000000000000000000000000002
11200010000000000000000000000000000011000000000000000000000000000001
110000100000000000000000000000000000110000000000000000000000000000
1100001000000000000000000000000000001100000000000000000000000002
11000010000000000000000000000000000011000000000222220000002200011
1100022000000000000000000000000000001100000000011111000000110000
11200010000000000000000000000000000000000222222100000000000000000
11000210000000000002000000000000000000000100000000000000000000000
112000100000000000000000000000000000000001
110002100000000000000000000022222222222221
11200010000000000000000000000000000011
11000210000000000000000000000000000011
11200010000000000000000000000000000011
11000210000000000000000000000000000011
11200010000000000000000000000000000011
11000210000000000000000000000000000011
11200010000000000000000000000000000011
11000210000000000000000000000000000011
11200010000000000000000000000000000011
11000210000000000000000000000000000011
11200010000000000000000000000000000011
11000210000000000000000000000000000011
11200010000000000000000000000000000011
11000210000000000000000000000000000011
11200010000000000000000000000000000011
11000210000000000000000000000000000011
11200010000000000000000000000000000011
11000210000000000000000000000000000011
11200010000000000000000000000000000011
1100021000000000000000000000000000111111
112000000000000000000000000000000000
1122222222222222222222222222222222222222222222222222222222222222222222222222222222222222222222222222222222222222222222222222222222222222222222222222222222222222222222222222222222222222222222222222222222222222222222222222222222222222222
1111111111111111111111111111111111111111111111111111111111111111111111111111111111111111111111111111111111111111111111111111111111111111111111111111111111111111111111111111111111111111111111111111111111111111111111111111111111111111111
1111111111111111111111111111111111111111111111111111111111111111111111111111111111111111111111111111111111111111111111111111111111111111111111111111111111111111111111111111111111111111111111111111111111111111111111111111111111111111111
1111111111111111111111111111111111111111111111111111111111111111111111111111111111111111111111111111111111111111111111111111111111111111111111111111111111111111111111111111111111111111111111111111111111111111111111111111111111111111111
1111111111111111111111111111111111111111111111111111111111111111111111111111111111111111111111111111111111111111111111111111111111111111111111111111111111111111111111111111111111111111111111111111111111111111111111111111111111111111111
1111111111111111111111111111111111111111111111111111111111111111111111111111111111111111111111111111111111111111111111111111111111111111111111111111111111111111111111111111111111111111111111111111111111111111111111111111111111111111111
1111111111111111111111111111111111111111111111111111111111111111111111111111111111111111111111111111111111111111111111111111111111111111111111111111111111111111111111111111111111111111111111111111111111111111111111111111111111111111111
1111111111111111111111111111111111111111111111111111111111111111111111111111111111111111111111111111111111111111111111111111111111111111111111111111111111111111111111111111111111111111111111111111111111111111111111111111111111111111111
1111111111111111111111111111111111111111111111111111111111111111111111111111111111111111111111111111111111111111111111111111111111111111111111111111111111111111111111111111111111111111111111111111111111111111111111111111111111111111111
1111111111111111111111111111111111111111111111111111111111111111111111111111111111111111111111111111111111111111111111111111111111111111111111111111111111111111111111111111111111111111111111111111111111111111111111111111111111111111111
1111111111111111111111111111111111111111111111111111111111111111111111111111111111111111111111111111111111111111111111111111111111111111111111111111111111111111111111111111111111111111111111111111111111111111111111111111111111111111111
1111111111111111111111111111111111111111111111111111111111111111111111111111111111111111111111111111111111111111111111111111111111111111111111111111111111111111111111111111111111111111111111111111111111111111111111111111111111111111111
1111111111111111111111111111111111111111111111111111111111111111111111111111111111111111111111111111111111111111111111111111111111111111111111111111111111111111111111111111111111111111111111111111111111111111111111111111111111111111111
1111111111111111111111111111111111111111111111111111111111111111111111111111111111111111111111111111111111111111111111111111111111111111111111111111111111111111111111111111111111111111111111111111111111111111111111111111111111111111111
1111111111111111111111111111111111111111111111111111111111111111111111111111111111111111111111111111111111111111111111111111111111111111111111111111111111111111111111111111111111111111111111111111111111111111111111111111111111111111111
1111111111111111111111111111111111111111111111111111111111111111111111111111111111111111111111111111111111111111111111111111111111111111111111111111111111111111111111111111111111111111111111111111111111111111111111111111111111111111111
1111111111111111111111111111111111111111111111111111111111111111111111111111111111111111111111111111111111111111111111111111111111111111111111111111111111111111111111111111111111111111111111111111111111111111111111111111111111111111111
1111111111111111111111111111111111111111111111111111111111111111111111111111111111111111111111111111111111111111111111111111111111111111111111111111111111111111111111111111111111111111111111111111111111111111111111111111111111111111111
1111111111111111111111111111111111111111111111111111111111111111111111111111111111111111111111111111111111111111111111111111111111111111111111111111111111111111111111111111111111111111111111111111111111111111111111111111111111111111111
1111111111111111111111111111111111111111111111111111111111111111111111111111111111111111111111111111111111111111111111111111111111111111111111111111111111111111111111111111111111111111111111111111111111111111111111111111111111111111111
1111111111111111111111111111111111111111111111111111111111111111111111111111111111111111111111111111111111111111111111111111111111111111111111111111111111111111111111111111111111111111111111111111111111111111111111111111111111111111111
1111111111111111111111111111111111111111111111111111111111111111111111111111111111111111111111111111111111111111111111111111111111111111111111111111111111111111111111111111111111111111111111111111111111111111111111111111111111111111111
1111111111111111111111111111111111111111111111111111111111111111111111111111111111111111111111111111111111111111111111111111111111111111111111111111111111111111111111111111111111111111111111111111111111111111111111111111111111111111111
1111111111111111111111111111111111111111111111111111111111111111111111111111111111111111111111111111111111111111111111111111111111111111111111111111111111111111111111111111111111111111111111111111111111111111111111111111111111111111111
1111111111111111111111111111111111111111111111111111111111111111111111111111111111111111111111111111111111111111111111111111111111111111111111111111111111111111111111111111111111111111111111111111111111111111111111111111111111111111111
1111111111111111111111111111111111111111111111111111111111111111111111111111111111111111111111111111111111111111111111111111111111111111111111111111111111111111111111111111111111111111111111111111111111111111111111111111111111111111111
1111111111111111111111111111111111111111111111111111111111111111111111111111111111111111111111111111111111111111111111111111111111111111111111111111111111111111111111111111111111111111111111111111111111111111111111111111111111111111111
1111111111111111111111111111111111111111111111111111111111111111111111111111111111111111111111111111111111111111111111111111111111111111111111111111111111111111111111111111111111111111111111111111111111111111111111111111111111111111111
1111111111111111111111111111111111111111111111111111111111111111111111111111111111111111111111111111111111111111111111111111111111111111111111111111111111111111111111111111111111111111111111111111111111111111111111111111111111111111111
1111111111111111111111111111111111111111111111111111111111111111111111111111111111111111111111111111111111111111111111111111111111111111111111111111111111111111111111111111111111111111111111111111111111111111111111111111111111111111111
1111111111111111111111111111111111111111111111111111111111111111111111111111111111111111111111111111111111111111111111111111111111111111111111111111111111111111111111111111111111111111111111111111111111111111111111111111111111111111111
1111111111111111111111111111111111111111111111111111111111111111111111111111111111111111111111111111111111111111111111111111111111111111111111111111111111111111111111111111111111111111111111111111111111111111111111111111111111111111111
1111111111111111111111111111111111111111111111111111111111111111111111111111111111111111111111111111111111111111111111111111111111111111111111111111111111111111111111111111111111111111111111111111111111111111111111111111111111111111111