11111111111111111111111111111111111111111111111111111111111111111111111111111111111111111110000000001111111111111111111111111111111111111111111111111111111111111111111111111111111111111111111111111111
10000000001000000000000000000010000000000000000000000000000000000000001000000000000000000110000000000000000000000000000000000000000000000000000000000100000000000000000001000000000000000000000000000001
10000000001000000000000000000010000000000000000000000000000000000000001000000000000000000110000000000000000000000000000000000000000000000000000000000100000000000000000001000000000000000000000000000001
10000000001000000000000000000010000000000000000000000000000000000000001000000000000000000110000000000000000000000000000000000000000000000000000000000100000000000000000001000000000000000000000000000001
10000000001000000000100000000010000000001111111111111111111100000000001000000000000000000110000000000000000000111111111111111111111111111111111111111100000000010000000001000000000111111111110000000001
10000000000000000000100000000010000000000000000000000000000110000000000000000001100000000000000000011000000000000000000000000000000000000001100000000000000000010000000001000000000000000000010000000001
10000000000000000000100000000010000000000000000000000000000010000000000000000001100000000000000000011000000000000000000000000000000000000001000000000000000000010000000001000000000000000000010000000001
10000000000000000000100000000010000000000000000000000000000010000000000000000001100000000000000000011000000000000000000000000000000000000001000000000000000000010000000001000000000000000000010000000001
10000000000000000000100000000010000000000000000000000000000010000000000000000001100000000000000000011000000000000000000000000000000000000001000000000000000000010000000001000000000000000000010000000001
11111111111111111111100000000011111111111111111111100000000011111111111111111111111111111111111111111111111111111111111111111111110000000001000000000111111111110000000001111111111100000000010000000001
10000000000000000000100000000000000000000000000000100000000000000000000000000001100000000000000000000000000001100000000000000000000000000001000000000000000000010000000001000000000000000000010000000001
10000000000000000000100000000000000000000000000000100000000000000000000000000001100000000000000000000000000001100000000000000000000000000001000000000000000000010000000001000000000000000000010000000001
10000000000000000000100000000000000000000000000000100000000000000000000000000001100000000000000000000000000001100000000000000000000000000001000000000000000000010000000001000000000000000000010000000001
10000000001000000000111111111111111111111000000000100000000011111111111111111111100000000011111111110000000001100000000100000000011111111111111111111100000000010000000001000000000111111111110000000001
10000000001000000000100000000000000000001000000000100000000000000000000000000000000000000110000000011000000001100000000110000000000000000001000000000100000000010000000000000000000100000000000000000001
10000000001000000000100000000000000000001000000000100000000000000000000000000000000000000110000000011000000001100000000110000000000000000001000000000100000000010000000000000000000100000000000000000001
10000000001000000000100000000000000000001000000000100000000000000000000000000000000000000110000000011000000001100000000110000000000000000001000000000100000000010000000000000000000100000000000000000001
10000000001000000000100000000000000000001000000000100000000000000000000000000000000000000110000000011000000001100000000110000000000000000001000000000100000000010000000000000000000100000000000000000001
10000000001000000000100000000000000000011000000000000000000010000000000000000001100000000000000000011000000000000000000110000000010000000000000000000100000000000000000000000000001100000000000000000011
10000000001000000000100000000000000000001000000000000000000010000000000000000001100000000000000000011000000000000000000110000000010000000000000000000100000000000000000000000000000100000000000000000001
10000000001000000000100000000000000000001000000000000000000010000000000000000001100000000000000000011000000000000000000110000000010000000000000000000100000000000000000000000000000100000000000000000001
10000000001000000000100000000000000000001000000000000000000010000000000000000001100000000000000000011000000000000000000110000000010000000000000000000100000000000000000000000000000100000000000000000001
10000000001000000000100000000010000000001111111111100000000010000000001111111111100000000011111111111111111111000000000110000000011111111111000000000100000000011111111111111111111111111111110000000001
10000000001000000000100000000010000000001000000000000000000010000000000000000000000000000000000000000000000001100000000110000000010000000000000000000100000000000000000000000000000100000000000000000001
10000000001000000000100000000010000000001000000000000000000010000000000000000000000000000000000000000000000001100000000110000000010000000000000000000100000000000000000000000000000100000000000000000001
10000000001000000000100000000010000000001000000000000000000010000000000000000000000000000000000000000000000001100000000110000000010000000000000000000100000000000000000000000000000100000000000000000001
10000000001100000001100000000010000000001000000000000000000110000000000000000000000000000000000000000000000001100000000110000000010000000000000000000100000000000000000000000000000100000000000000000011
10000000000000000000000000000010000000001000000000100000000000000000011000000000000000000000000000000000000001100000000110000000000000000000000000000100000000010000000001000000000100000000000000000001
10000000000000000000000000000010000000001000000000100000000000000000001000000000000000000000000000000000000001100000000110000000000000000000000000000100000000010000000001000000000100000000000000000001
10000000000000000000000000000010000000001000000000100000000000000000001000000000000000000000000000000000000001100000000110000000000000000000000000000100000000010000000001000000000100000000000000000001
10000000000000000000000000000010000000001000000000100000000000000000001000000000000000000000000000000000000001100000000110000000000000000000000000000100000000010000000001000000000100000000000000000001
10000000001111111111111111111110000000001000000000100000000010000000001000000000111111111111111111111000000001100000000111111111111111111111000000000100000000010000000001000000000111111111110000000001
10000000001000000000000000000000000000001000000000000000000010000000001000000000000000000110000000011000000001100000000000000000000000000001000000000000000000010000000000000000000000000000010000000001
10000000001000000000000000000000000000001000000000000000000010000000001000000000000000000110000000011000000001100000000000000000000000000001000000000000000000010000000000000000000000000000010000000001
10000000001000000000000000000000000000001000000000000000000010000000001000000000000000000110000000011000000001100000000000000000000000000001000000000000000000010000000000000000000000000000010000000001
11111111111000000000111111111111111111111111111111111111111110000000001111111111000000000110000000011000000001111111111111111111110000000001111111111111111111111111111111111111111100000000010000000001
10000000000000000000100000000000000000000000000000000000000000000000001000000000000000000110000000000000000001100000000000000000010000000001000000000000000000000000000000000000000100000000010000000001
10000000000000000000100000000000000000000000000000000000000000000000001000000000000000000110000000000000000001100000000000000000010000000001000000000000000000000000000000000000000100000000010000000001
10000000000000000000100000000000000000000000000000000000000000000000001000000000000000000110000000000000000001100000000000000000010000000001000000000000000000000000000000000000000100000000010000000001
10000000000000000000100000000000000000000000000000000000000000000000011000000000000000000110000000000000000001100000000000000000010000000001000000000000000000000000000000000000000100000000010000000001
10000000001111111111100000000011111111111000000000100000000011111111110000000001100000000011111111111111111111000000000110000000000000000001000000000111111111111111111111111111111100000000010000000001
10000000000000000000000000000010000000000000000000100000000000000000000000000001100000000000000000011000000000000000000110000000000000000001000000000000000000000000000000000000000000000000010000000001
10000000000000000000000000000010000000000000000000100000000000000000000000000001100000000000000000011000000000000000000110000000000000000001000000000000000000000000000000000000000000000000010000000001
10000000000000000000000000000010000000000000000000100000000000000000000000000001100000000000000000011000000000000000000110000000000000000001000000000000000000000000000000000000000000000000010000000001
11111111111111111111111111111111111111111111111111111111111111111111111111111111111111111111111111111000000001111111111111111111111111111111111111111111111111111111111111111111111111111111111111111111