
1111111111111111111111111111111111111111111111111111111111111111111111111111111111111111111111111111111111111111111111111111111111111111111111111111111111111111111111111111111111111111111111111111111111111111111111111111111111111111111111111111111111111111111111111111111111111111111111111111111111111111111111111111111111111111111111111111111111111111111111111111111111111111111111111111111111111111
1000000000000000000000000000000000000000000000000000000000000000000000000000000000000000000000000000000000000000000000000000000000000000000000000000000000000000000000000000000000000000000000000000000000000000000000000000000000000000000000000000000000000000000000000000000000000000000000000000000000000000000000000000000000000000000000000000000000000000000000000000000000000000000000000000000000000001
1000000000000000000000000000000000000000000000000000000000000000000000000000000000000000000000000000000000000000000000000000000000000000000000000000000000000000000000000000000000000000000000000000000000000000000000000000000000000000000000000000000000000000000000000000000000000000000000000000000000000000000000000000000000000000000000000000000000000000000000000000000000000000000000000000000000000001
1000000000000000000000000000000000000000000000000000000000000000000000000000000000000000000000000000000000000000000000000000000000000000000000000000000000000000000000000000000000000000000000000000000000000000000000000000000000000000000000000000000000000000000000000000000000000000000000000000000000000000000000000000000000000000000000000000000000000000000000000000000000000000000000000000000000000001
1000000000000000000000000000000000000000000000000000000000000000000000000000000000000000000000000000000000000000000000000000000000000000000000000000000000000000000000000000000000000000000000000000000000000000000000000000000000000000000000000000000000000000000000000000000000000000000000000000000000000000000000000000000000000000000000000000000000000000000000000000000000000000000000000000000000000001
1000000000000000000000000000000000000000000000000000000000000000000000000000000000000000000000000000000000000000000000000000000000000000000000000000000000000000000000000000000000000000000000000000000000000000000000000000000000000000000000000000000000000000000000000000000000000000000000000000000000000000000000000000000000000000000000000000000000000000000000000000000000000000000000000000000000000001
1000000000000000000000000000000000000000000000000000000000000000000000000000000000000000000000000000000000000000000000000000000000000000000000000000000000000000000000000000000000000000000000000000000000000000000000000000000000000000000000000000000000000000000000000000000000000000000000000000000000000000000000000000000000000000000000000000000000000000000000000000000000000000000000000000000000000001
1000000000000000000000000000000000000000000000000000000000000000000000000000000000000000000000000000000000000000000000000000000000000000000000000000000000000000000000000000000000000000000000000000000000000000000000000000000000000000000000000000000000000000000000000000000000000000000000000000000000000000000000000000000000000000000000000000000000000000000000000000000000000000000000000000000000000001
1000000000000000000000000000000000000000000000000000000000000000000000000000000000000000000000000000000000000000000000000000000000000000000000000000000000000000000000000000000000000000000000000000000000000000000000000000000000000000000000000000000000000000000000000000000000000000000000000000000000000000000000000000000000000000000000000000000000000000000000000000000000000000000000000000000000000001
1000000000000000000000000000000000000000000000000000000000000000000000000000000000000000000000000000000000000000000000000000000000000000000000000000000000000000000000000000000000000000000000000000000000000000000000000000000000000000000000000000000000000000000000000000000000000000000000000000000000000000000000000000000000000000000000000000000000000000000000000000000000000000000000000000000000000001
1000000000000000000000000000000000000000000000000000000000000000000000000000000000000000000000000000000000000000000000000000000000000000000000000000000000000000000000000000000000000000000000000000000000000000000000000000000000000000000000000000000000000000000000000000000000000000000000000000000000000000000000000000000000000000000000000000000000000000000000000000000000000000000000000000000000000001
1111111111111111111111111111111111111111111111111111111111111111111111111111111111111111111111111111111111111111111111111111111111111111111111111111111111111111111111111111111111111111111000000000000111111111111111111111111111111111111111111111111111111111111111111111111111111111111111111111111111111111111111111111111111111111111111111111111111111111111111111111111111111111111111111111111111111111
1100000000000000000000000000000000000000000000000000000000000000001100000000000000000000000000000000000000000000000000011000000000000000000000000000000000000000000000000000000000000000000000000000000000000000000000000000000000000000000000000000000000000000000000000000000000000001100000000000000000000000000000000000000000000000000000000000000001100000000000000000000000000000000000000000000000000011
1100000000000000000000000000000000000000000000000000000000000000001100000000000000000000000000000000000000000000000000011000000000000000000000000000000000000000000000000000000000000000000000000000000000000000000000000000000000000000000000000000000000000000000000000000000000000001100000000000000000000000000000000000000000000000000000000000000001100000000000000000000000000000000000000000000000000011
1100000000000000000000000000000000000000000000000000000000000000001100000000000000000000000000000000000000000000000000011000000000000000000000000000000000000000000000000000000000000000000000000000000000000000000000000000000000000000000000000000000000000000000000000000000000000011100000000000000000000000000000000000000000000000000000000000000001100000000000000000000000000000000000000000000000000011
1100000000000111111111111111111111111111100000000000011111111111111100000000000011111111111111111111111111110000000000011000000000000100000000000011111111111111111111111111111111111111111111111111111111111111111111111111111111111111111111111111111111111111111111111111111111111111000000000000110000000000011111111111111111111111111110000000000001100000000000011111111111111111111111111100000000000011
1100000000000110000000000000000000000000100000000000000000000000000000000000000010000000000000000000000000110000000000011000000000000100000000000000000000000001100000000000000000000000001100000000000000000000000011000000000000100000000000000000000000000000000000000000000000000000000000000000110000000000011000000000000000000000000000000000000001100000000000010000000000000000000000000000000000000011
1100000000000110000000000000000000000000110000000000000000000000000000000000000010000000000000000000000000110000000000011000000000000100000000000000000000000001100000000000000000000000001100000000000000000000000011000000000000100000000000000000000000000000000000000000000000000000000000000000110000000000011000000000000000000000000000000000000001100000000000010000000000000000000000000000000000000011
1111111111111110000000000001000000000000111111111111111000000000000111111111111110000000000001000000000000110000000000011000000000000111111111111111000000000001100000000000010000000000001100000000000110000000000011000000000000100000000000011111111111111111111111111111111111111111111111111111110000000000011000000000000111111111111111111111111111100000000000011111111111111111111111111111111111111111
1100000000000000000000000001000000000000000000000000011000000000001100000000000000000000000001100000000000000000000000011000000000000100000000000000000000000001100000000000010000000000001100000000000110000000000000000000000000100000000000000000000000001100000000000000000000000000000000000000110000000000011000000000000000000000000000000000000001100000000000000000000000001000000000000000000000000011
1100000000000000000000000011000000000000000000000000011000000000001100000000000000000000000001100000000000000000000000011000000000000100000000000000000000000001100000000000010000000000001100000000000110000000000000000000000000110000000000000000000000001100000000000000000000000000000000000000110000000000011000000000000000000000000000000000000001100000000000000000000000001000000000000000000000000011
1100000000000111111111111111111111111111100000000000011111111111111100000000000011111111111111100000000000110000000000011111111111111100000000000011111111111111100000000000010000000000001100000000000111111111111111000000000000111111111111111000000000001100000000000011111111111111000000000000110000000000011111111111111111111111111111111111111111111111111111110000000000001000000000000110000000000011
1100000000000000000000000001000000000000100000000000000000000000001100000000000010000000000001100000000000110000000000011000000000000000000000000000000000000000000000000000010000000000001100000000000000000000000011000000000000100000000000000000000000001100000000000010000000000000000000000000110000000000011000000000000000000000000000000000000000000000000000010000000000000000000000000110000000000011
1100000000000000000000000001000000000000100000000000000000000000001100000000000010000000000001100000000000110000000000011000000000000000000000000000000000000000000000000000010000000000001100000000000000000000000011000000000000100000000000000000000000001100000000000010000000000000000000000000110000000000011000000000000000000000000000000000000000000000000000010000000000000000000000000110000000000011
1111111111111110000000000001000000000000111111111111110000000000001100000000000010000000000001100000000000111111111111111000000000000100000000000011111111111111111111111111110000000000001111111111111110000000000011111111111111100000000000011111111111111100000000000010000000000001111111111111110000000000011111111111111111111111111110000000000000111111111111111111111111111111111111111110000000000011
1100000000000110000000000000000000000000000000000000011000000000001100000000000000000000000001100000000000110000000000000000000000000100000000000011000000000000000000000000110000000000001100000000000000000000000011100000000000000000000000000000000000001100000000000010000000000000000000000000000000000000011000000000000000000000000011000000000000000000000000111000000000000000000000000110000000000011
1100000000000111111111111111111111111111100000000000011000000000001111111111111111111111111111100000000000110000000000001111111111111100000000000011000000000001111111111111110000000000001100000000000110000000000011000000000000111111111111111111111111111100000000000011111111111111000000000000111111111111111000000000000100000000000011111111111111100000000000010000000000001000000000000110000000000011
1100000000000000000000000001000000000000000000000000011000000000000000000000000010000000000000000000000000110000000000011000000000000000000000000011000000000000000000000000000000000000001100000000000110000000000000000000000000100000000000011000000000000000000000000010000000000001100000000000110000000000000000000000000100000000000011000000000001100000000000000000000000001000000000000000000000000011
1100000000000000000000000001000000000000000000000000011000000000000000000000000010000000000000000000000000110000000000011100000000000000000000000011000000000000000000000000000000000000001100000000000110000000000000000000000000100000000000011000000000000000000000000110000000000001100000000000110000000000000000000000001100000000000011000000000001100000000000000000000000011100000000000000000000000011
1100000000000110000000000001000000000000111111111111110000000000001100000000000010000000000001111111111111110000000000001111111111111111111111111111111111111111111111111111110000000000001111111111111111111111111111000000000000100000000000011000000000000111111111111110000000000001100000000000100000000000011111111111111100000000000011000000000001100000000000011111111111111111111111111111111111111111
1100000000000110000000000000000000000000110000000000000000000000001100000000000010000000000001100000000000000000000000000000000000000100000000000000000000000001100000000000000000000000000000000000000110000000000000000000000000000000000000011000000000000000000000000000000000000001100000000000000000000000011000000000000100000000000011000000000001100000000000000000000000000000000000000000000000000011
1100000000000110000000000000000000000000100000000000000000000000001100000000000010000000000001100000000000000000000000000000000000000100000000000000000000000001100000000000000000000000000000000000000110000000000000000000000000000000000000011000000000000000000000000000000000000001100000000000000000000000011000000000000100000000000011000000000001100000000000000000000000000000000000000000000000000011
1100000000000111111111111111000000000000100000000000011111111111111100000000000010000000000001100000000000111111111111111000000000000100000000000011000000000001111111111111111111111111111000000000000111111111111111111111111111100000000000011111111111111111111111111111111111111111000000000000111111111111111000000000000100000000000011000000000001111111111111111111111111111111111111111110000000000011
1100000000000000000000000001000000000000100000000000000000000000001100000000000000000000000001100000000000110000000000000000000000000100000000000011000000000000000000000000010000000000000000000000000000000000000000000000000000100000000000000000000000000000000000000010000000000000000000000000110000000000011000000000000100000000000011000000000000000000000000010000000000000000000000000000000000000011
1100000000000000000000000001000000000000110000000000000000000000001100000000000000000000000001100000000000110000000000000000000000000100000000000011000000000000000000000000010000000000000000000000000000000000000000000000000000110000000000000000000000000000000000000010000000000000000000000000110000000000011000000000000100000000000011000000000000000000000000010000000000000000000000000000000000000011
1111111111111110000000000001000000000000111111111111111000000000001111111111111111111111111111100000000000110000000000001111111111111100000000000011111111111111100000000000011111111111111111111111111111111111111111000000000000111111111111111111111111111100000000000010000000000001111111111111110000000000011000000000000100000000000011000000000001100000000000011111111111111000000000000111111111111111
1100000000000110000000000001000000000000000000000000011000000000001100000000000000000000000000000000000000110000000000000000000000000100000000000000000000000001100000000000000000000000000000000000000110000000000011000000000000000000000000011000000000000000000000000010000000000000000000000000000000000000000000000000000100000000000011000000000001100000000000000000000000001000000000000000000000000011
1100000000000110000000000001000000000000000000000000011000000000001100000000000000000000000000000000000000110000000000000000000000000100000000000000000000000001100000000000000000000000000000000000000110000000000011000000000000000000000000011000000000000000000000000010000000000000000000000000000000000000000000000000000100000000000011000000000001100000000000000000000000001000000000000000000000000011
1100000000000110000000000001111111111111111111111111111000000000001100000000000011111111111111111111111111111111111111111000000000000111111111111110000000000001111111111111111111111111111000000000000110000000000011111111111111100000000000011111111111111111111111111110000000000001111111111111111111111111111111111111111100000000000011000000000001111111111111110000000000001111111111111100000000000011
1100000000000110000000000000000000000000100000000000000000000000001100000000000000000000000001100000000000000000000000011000000000000000000000000000000000000001100000000000010000000000000000000000000110000000000000000000000000100000000000000000000000001100000000000000000000000001100000000000110000000000000000000000000000000000000011000000000000000000000000010000000000000000000000000000000000000011
1100000000000110000000000000000000000000100000000000000000000000001100000000000000000000000001100000000000000000000000011000000000000000000000000000000000000001100000000000010000000000000000000000000110000000000000000000000000100000000000000000000000001100000000000000000000000001100000000000110000000000000000000000000000000000000011000000000000000000000000010000000000000000000000000000000000000011
1100000000000111111111111111000000000000100000000000011000000000001111111111111110000000000001100000000000110000000000001111111111111111111111111111111111111111100000000000010000000000001111111111111110000000000001111111111111111111111111111000000000001100000000000011111111111111000000000000110000000000001111111111111111111111111111111111111111100000000000011111111111111111111111111111111111111111
1100000000000000000000000000000000000000100000000000011000000000000000000000000010000000000001100000000000110000000000000000000000000000000000000011000000000000000000000000010000000000000000000000000110000000000011000000000000000000000000011000000000000000000000000010000000000000000000000000110000000000000000000000000000000000000011000000000000000000000000010000000000000000000000000000000000000011
1100000000000000000000000000000000000001100000000000011000000000000000000000000010000000000001100000000000110000000000000000000000000000000000000011000000000000000000000000111000000000000000000000000110000000000011000000000000000000000000011000000000000000000000000010000000000000000000000000110000000000000000000000000000000000000011000000000000000000000000110000000000000000000000000000000000000011
1100000000000110000000000001111111111111100000000000011000000000001100000000000010000000000001100000000000111111111111111000000000000100000000000010000000000001111111111111111111111111111100000000000110000000000001000000000000100000000000011111111111111100000000000010000000000001100000000000111111111111111111111111111111111111111111000000000000111111111111110000000000001111111111111110000000000011
1100000000000110000000000000000000000000100000000000011000000000001100000000000010000000000001100000000000110000000000000000000000000100000000000000000000000001100000000000000000000000001100000000000110000000000000000000000000100000000000000000000000001100000000000000000000000001100000000000000000000000000000000000000000000000000011000000000000000000000000000000000000001000000000000110000000000011
1100000000000111111111111111111111111111100000000000011000000000001111111111111110000000000001111111111111110000000000001111111111111111111111111111111111111111100000000000010000000000001100000000000111111111111111111111111111111111111111111000000000001111111111111111111111111111111111111111111111111111111000000000000100000000000011000000000001111111111111111111111111111000000000000110000000000011
1100000000000110000000000001000000000000000000000000011000000000001100000000000000000000000000000000000000110000000000011000000000000000000000000000000000000000000000000000010000000000001100000000000110000000000000000000000000100000000000000000000000000000000000000010000000000000000000000000000000000000011000000000000100000000000000000000000000000000000000010000000000001000000000000000000000000011
1100000000000110000000000001000000000000111111111111111000000000001100000000000011111111111111100000000000110000000000011000000000000111111111111111111111111111111111111111110000000000001000000000000110000000000011000000000000111111111111111111111111111100000000000010000000000001000000000000111111111111111000000000000111111111111111111111111111100000000000010000000000001111111111111110000000000011
1100000000000000000000000001000000000000110000000000000000000000001100000000000010000000000001100000000000000000000000011000000000000000000000000011000000000000000000000000010000000000000000000000000110000000000011000000000000100000000000000000000000000000000000000010000000000001100000000000000000000000000000000000000100000000000000000000000000000000000000110000000000000000000000000110000000000011
1111111111111110000000000001000000000000111111111111111111111111111100000000000010000000000001100000000000011111111111111111111111111100000000000011000000000000100000000000011111111111111111111111111110000000000011000000000000100000000000011111111111111111111111111110000000000001100000000000111111111111111111111111111111111111111111111111111111111111111111111111111111111000000000000111111111111111
1100000000000000000000000001000000000000000000000000000000000000000000000000000010000000000001100000000000000000000000000000000000000100000000000000000000000001100000000000000000000000001100000000000000000000000011000000000000100000000000000000000000000000000000000000000000000001100000000000000000000000000000000000000100000000000000000000000001100000000000000000000000001000000000000000000000000011
1111111111111111111111111111111111111111111111111111111111111111111111111111111110000000000001111111111111110000000000001000000000000111111111111111111111111111111111111111110000000000001000000000000111111111111111000000000000111111111111111000000000001111111111111111111111111111111111111111111111111111111111111111111100000000000011000000000001111111111111110000000000001111111111111110000000000011
1100000000000000000000000001000000000000000000000000000000000000000000000000000000000000000000000000000000110000000000011000000000000100000000000000000000000000000000000000010000000000000000000000000110000000000000000000000000100000000000011000000000001100000000000000000000000000000000000000000000000000000000000000000100000000000011000000000000000000000000010000000000000000000000000110000000000011
1100000000000000000000000001000000000000000000000000000000000000000000000000000000000000000000000000000000110000000000011100000000001100000000000000000000000000000000000000111000000000000000000000000110000000000000000000000001100000000000011000000000001100000000000000000000000000000000000000000000000000000000000000000100000000000011000000000000000000000000011000000000000000000000000110000000000011
1100000000000110000000000001000000000000111111111111111111111111111111111111111111111111111111000000000000110000000000001111111111111100000000000011111111111111111111111111111111111111111111111111111110000000000001111111111111100000000000011000000000000100000000000010000000000001100000000000111111111111111000000000000100000000000011111111111111100000000000011111111111111000000000000100000000000011
1100000000000110000000000000000000000000000000000000011000000000001100000000000000000000000000000000000000110000000000000000000000000100000000000000000000000000000000000000010000000000000000000000000110000000000000000000000000100000000000011000000000000000000000000010000000000001100000000000000000000000011000000000000100000000000011000000000000000000000000010000000000000000000000000000000000000011
1100000000000110000000000000000000000000000000000000011000000000001100000000000000000000000000000000000000110000000000000000000000000100000000000000000000000000000000000000010000000000000000000000000110000000000000000000000000100000000000011000000000000000000000000010000000000001100000000000000000000000011000000000000100000000000011000000000000000000000000110000000000000000000000000000000000000011
1100000000000111111111111111111111111111100000000000011000000000001100000000000011111111111111111111111111111111111111111000000000000100000000000011111111111111100000000000010000000000001000000000000111111111111111000000000000100000000000011111111111111111111111111110000000000001111111111111110000000000011000000000000100000000000011000000000001111111111111110000000000001111111111111111111111111111
1100000000000000000000000001000000000000000000000000011000000000001100000000000010000000000000000000000000110000000000000000000000000100000000000011000000000000000000000000110000000000001100000000000110000000000000000000000000110000000000000000000000001100000000000010000000000001100000000000000000000000011000000000000000000000000011000000000001100000000000010000000000001000000000000000000000000011
1111111111111110000000000001000000000000100000000000011000000000000100000000000010000000000001100000000000111111111111111000000000000100000000000011000000000000111111111111111111111111111000000000000110000000000011111111111111111111111111111000000000001100000000000010000000000001100000000000111111111111111111111111111111111111111110000000000001100000000000010000000000001000000000000110000000000011
1100000000000110000000000001000000000000100000000000011000000000000000000000000010000000000001100000000000000000000000011000000000000100000000000011000000000000000000000000000000000000000000000000000110000000000011000000000000000000000000011000000000001100000000000000000000000001100000000000000000000000011000000000000000000000000000000000000000000000000000010000000000000000000000000110000000000011
1100000000000110000000000001000000000000100000000000011111111111111111111111111110000000000001111111111111110000000000001000000000000111111111111111111111111111111111111111110000000000001000000000000110000000000011000000000000100000000000011000000000001111111111111111111111111111000000000000110000000000011000000000000111111111111111111111111111111111111111110000000000001111111111111110000000000011
1100000000000000000000000011000000000000110000000000000000000000000000000000000000000000000000000000000000110000000000000000000000000000000000000000000000000000000000000000000000000000001100000000000110000000000011000000000000110000000000000000000000000000000000000000000000000000000000000000110000000000011000000000000000000000000000000000000000000000000000000000000000001100000000000000000000000011
1111111111111111111111111111111111111111111111111111111111111111111111111111111111111111111111111111111111111111111111111111111111111111111111111111111111111111111111111111111111111111111111111111111110000000000011111111111111111111111111111111111111111111111111111111111111111111111111111111111111111111111111111111111111111111111111111111111111111111111111111111111111111111111111111111111111111111
1000000000000000000000000000000000000000000000000000000000000000000000000000000000000000000000000000000000000000000000000000000000000000000000000000000000000000000000000000000000000000000000000000000000000000000000000000000000000000000000000000000000000000000000000000000000000000000000000000000000000000000000000000000000000000000000000000000000000000000000000000000000000000000000000000000000000001
1000000000000000000000000000000000000000000000000000000000000000000000000000000000000000000000000000000000000000000000000000000000000000000000000000000000000000000000000000000000000000000000000000000000000000000000000000000000000000000000000000000000000000000000000000000000000000000000000000000000000000000000000000000000000000000000000000000000000000000000000000000000000000000000000000000000000001
1000000000000000000000000000000000000000000000000000000000000000000000000000000000000000000000000000000000000000000000000000000000000000000000000000000000000000000000000000000000000000000000000000000000000000000000000000000000000000000000000000000000000000000000000000000000000000000000000000000000000000000000000000000000000000000000000000000000000000000000000000000000000000000000000000000000000001
1111111111111111111111111111111111111111111111111111111111111111111111111111111111111111111111111111111111111111111111111111111111111111111111111111111111111111111111111111111111111111111111111111111111111111111111111111111111111111111111111111111111111111111111111111111111111111111111111111111111111111111111111111111111111111111111111111111111111111111111111111111111111111111111111111111111111111
