111111111111111111111111111111111111111111111111111111111111111111111111111111111111111111111111111111111111111111111111111111111111111111111111111111111111111111111111111111111111111111111111111111111111111111111111111111111111111111111111111111111111111111111111111111111111111111111111111111111111
111111111111111111111111111111111111111111111111111111111111111111111111111111111111111111111111111111111111111111111111111111111111111111111111111111111111111111111111111111111111111111111111111111111111111111111111111111111111111111111111111111111111111111111111111111111111111111111111111111111111
111111111111111111111111111111111111111111111111111111111111111111111111111111111111111111111111111111111111111111111111111111111111111111111111111111111111111111111111111111111111111111111111111111111111111111111111111111111111111111111111111111111111111111111111111111111111111111111111111111111111
111111111111111111111111111111111111111111111111111111111111111111111111111111111111111111111111111111111111111111111111111111111111111111111111111111111111111111111111111111111111111111111111111111111111111111111111111111111111111111111111111111111111111111111111111111111111111111111111111111111111
111111111111111111111111111111111111111111111111111111111111111111111111111111111111111111111111111111111111111111111111111111111111111111111111111111111111111111111111111111111111111111111111111111111111111111111111111111111111111111111111111111111111111111111111111111111111111111111111111111111111
1000000000000000000000000000000000000000000000000000000000000000000000000000000000000000000000000000000000000000000000000000000s500500000505000000050050000000000000000000000000000000000000000000000000000000000000000000000000000000000000000000000000000000000000000000000000000000000000000000000000001
100000000000000000000000000000000000000000000000000000000000000000000000000000000000000000000000000000000000000000000000000000005000500050050005550500500000000000000000000000000000000000000000000000000000000000000000000000000000000000000000000000000000000000000000000000000000000000000000000000000001
100000000000000000000000000000000000000000000000000000000000000000000000000000000000000000000000000000000000000000000000000000005000050500050000000500500000000000000000000000000000000000000000000000000000000000000000000000000000000000000000000000000000000000000000000000000000000000000000000000000001
100000000000000000000000000000000000000000000000000000000000000000000000000000000000000000000000000000000000000000000000000000005550005000055500000500500000000000000000000000000000000000000000000000000000000000000000000000000000000000000000000000000000000000000000000000000000000000000000000000000001
100000000000000000000000000000000000000000000000000000000000000000000000000000000000000000000000000000000000000000000000000000000000000000000000000000000000000000000000000000000000000000000000000000000000000000000000000000000000000000000000000000000000000000000000000000000000000000000000000000000001
100000000000000000000000000000000000000000000000000000000000000000000000000000000000000000000000000000000000000000000000000000000000000000000000000000000000000000000000000000000000000000000000000000000000000000000000000000000000000000000000000000000000000000000000000000000000000000000000000000000001
122222222222222222222222222222222222222222222222222222222222222222222222222222222222222222222222222222222222222222222222222222222222222222222222200000000002222222222222222222222222222222222222222222222222222222222222222222222222222222222222222222222222222222222222222222222222222222222222222222222221
100000000000100000000000000000000000000000000000000000000000000000000000100000000000000000000000000000000001100000000000000000000000000000000000000000000000000000000000000000000001100000000000000000000000000000000000000000000000000000000000000000000000000000000000000000000000000000000001000000000001
100000000000100000000000000000000000000000000000000000000000000000000000100000000000000000000000000000000001100000000000000000000000000000000000000000000000000000000000000000000001100000000000000000000000000000000000000000000000000000000000000000000000000000000000000000000000000000000001000000000001
100000000000100000000000000000000000222222222222222222222222200000000000122222222222222222222222200000000001100000000002222222222222200000000002222000000002222222222222222222222221100000000000000000000000000000000000000000000000222222222222222222222222222222222222222222222222000000000001000000000001
100000000000122222222222222222222222200000000000100000000000100000000000100000000000111111111111100000000001100000000001100000000001100000000001100000000001100000000000000000000001122222222200000000000002222222222222000000000000000000000000000000000001000000000001000000000001000000000001000000000001
100000000000110000000000000000000000000000000000100000000000100000000000000000000000100000000000000000000001100000000001100000000001100000000001100000000001100000000000000000000000000000000100000000000000000000000001000000000000000000000000000000000001000000000001000000000001000000000001000000000001
100000000000110000000000000000000000000000000000100000000000100000000000000000000000100000000000000000000001100000000001100000000001100000000001100000000001100000000000000000000000000000000100000000000000000000000001000000000000000000000000000000000001000000000001000000000001000000000001000000000001
122222222222100000000000222222222222222222222222100000000000100000000000122222222222122222222222222222222221100000000001100000000001100000000001122222222221100000000221122222222222000000000222222222222222220000000001222222222222222222222221000000000001000000000001000000000001000000000001000000000001
110000000000000000000000100000000000000000000000100000000000000000000000100000000000000000000000000000000001100000000000000000000001100000000000000000000000000000000001100000000000000000000000000000000001000000000001100000000000000000000000000000000001000000000001000000000001000000000000000000000001
110000000000000000000000100000000000000000000000100000000000000000000000100000000000000000000000000000000001100000000000000000000001100000000000000000000000000000000001100000000000000000000000000000000001000000002221100000000000000000000000000000000001000000000001000000000001000000000000000000000001
100000000000200000000000100000000000200000000000122222222222222222222222100000000000222222222222200000000000000000000002222222222222222222222222222222222222222000000001100000000022220000000002222222222222000000000001000000000002222222222222222222222221222222222221000000000001222222222222000000000001
100000000000100000000000100000000000100000000000000000000000000000000000100000000000000000000001100000000000000000000001100000000000000000000000000000000001100000000001100000000001100000000001100000000000000000000001000000000000000000000001000000000000000000000000000000000001000000000000000000000001
100000000000100000000000100000000000100000000000000000000000000000000000100000000000000000000001100000000000000000000001100000000000000000000000000000000001100000000001100000000001122200000001100000000000000000000001000000000000000000000001000000000000000000000000000000000001000000000000000000000001
100000000000100000000000100000000000122222222222222222222222200000000000100000000000222222222221122222222222200000000001100000000000222222222222200000000001111111111111000000000001100000000001100000000001111111111111111111111111000000000001000000000002222222222222222222222221000000000002222222222221
100000000000100000000000100000000000100000000000000000000000100000000000000000000000100000000000000000000001100000000001100000000000000000000001100000000000000000000000000000000001100000000001100000000000000000000000000000000001000000000001000000000000000000000000000000000000000000000000000000000001
100000000000100000000000100000000000100000000000000000000000100000000000000000000000100000000000000000000001100000000001100000000000000000000001100000000000000000000000000000000001100000000001100000000000000000000000000000000001000000000001000000000000000000000000000000000000000000000000000000000001
100000000000122222222222100000000000100000000000200000000000122222222222222222222222100000000002200000000001122222222221122222222222000000000001122222222222000000000002222222222222222222222222222222222222222222222222000000000001000000000001000000000002222222222222222222222222222222222222222222222221
100000000000000000000000100000000000100000000000100000000000100000000000000000000000000000000001100000000000000000000000000000000000000000000001100000000000000000000001100000000000000000000000000000000001000000000000000000000001000000000001000000000001000000000000000000000001000000000000000000000001
100000000000000000000000100000000000100000000000100000000000100000000000000000000000000000000001100000000000000000000000000000000000000000000001100000000000000000000001100000000000000000000000000000000001000000000000000000000001000000000001000000000001000000000000000000000001000000000000000000000001
100000000000220000000000100000000000100000000000100000000000100000000000022222222222222222222221122222222222222222222222200000000002222222222221122222222222222222222221100000000002200000000002200000000001000000222222222222222221000000000001222222222221000000000002000000000001000000000022000000000001
100000000000110000000000000000000000100000000000100000000000100000000000000000000000000000000000000000000000000000000001100000000001100000000000000000000000000000000000000000000001100000000001100000000001000000000001000000000001000000000000000000000000000000000001000000000000000000000011000000000001
100000000000110000000000000000000000100000000000100000000000100000000000000000000000000000000000000000000000000000000001100000000001100000000000000000000000000000000000000000000001100000000001100000000001000000000001000000000001000000000000000000000000000000000001000000000000000000000011000000000001
100000000000112222222222222222222222100000000000122222222222222222222222222222222222222222222222222222222222200000000001122222222221100000000002222222222222222222222222222222222221100000000001111111111111222000000001000000000001111111111111111111111111111111111111111111111111111111111111000000000001
100000000000000000000000100000000000100000000000000000000000000000000000100000000000000000000000000000000001100000000000000000000000000000000001100000000001100000000000000000000001100000000000000000000001000000000000000000000001000000000000000000000000000000000000000000000001000000000000000000000001
100000000000000000000000100000000000100000000000000000000000000000000000100000000000000000000000000000000001100000000000000000000000000000000001100000000001100000000000000000000001100000000000000000000001000000000000000000000001000000000000000000000000000000000000000000000001000000000000000000000001
122222222222200000000000100000000000100000000000222222222222200000000000100000000000222222222222200000000001122222222222222222222222222222222221100000000001100000000001100000000001122222222222000000000001222222222222000000000001000000000002222222222222222222222222000000000001000000000222220000000001
100000000000100000000000100000000000100000000000100000000000000000000000100000000000100000000000100000000000000000000000000000000000000000000000000000000001100000000001100000000001100000000000000000000001000000000000000000000000000000000001000000000000000000000001000000000001000000000001000000000001
100000000000100000000000100000000000100000000000100000000000000000000000100000000000100000000000100000000000000000000000000000000000000000000000000000000001100000000001100000000221100000000000000000000001000000000000000000000000000000000001000000000000000000000001000000000001000000000001000000000001
100000000000100000000000100000000000100000000000100000000000222222222222100000000000100000000000122222222222200000000002222222222222222222222222222222222221100000000001100000000001100000000002222222222221000000000002222222222222222222222221000000000002000000000001222222222221000000000001000000000001
100000000000100000000000100000000000000000000000100000000000000000000000000000000000000000000000100000000001100000000001100000000000000000000000000000000001100000000001100000000001100000000000000000000000000000000001000000000000000000000000000000000001000000000000000000000000000000000001000000000001
100000000000100000000000100000000000000000000000100000000000000000000000000000000000000000000000100000000001100000000001100000000000000000000000000000000001100000000001122000000001100000000000000000000000000000000001000000000000000000000000000000000001000000000000000000000000000000000001000000000001
100000000000100000000000122222222222222222222222122222222222222222222222222222222222200000000000100000000001100000000001100000000000222222222222200000000001100000000001100000000001122222222222222222222222222222222221000000000002222222222222222222222221222222222222222222222222222222222221000000000001
100000000000000000000000100000000000000000000000000000000000100000000000000000000000100000000000000000000001100000000000000000000000000000000001100000000001100000000001100000000000000000000000000000000000000000000001000000000001000000000000000000000000000000000000000000000000000000000001000000000001
100000000000000000000000100000000000000000000000000000000000100000000000000000000000100000000000000000000001100000000000000000000000000000000001100000000001100000000001100000000000000000000000000000000000000000000001000000000001000000000000000000000000000000000000000000000000000000000001000000000001
100000000000222222222222100000000002222222222222210000000000100000000000200000000000122222222222200000000001122222222222222222222222222222222221100000000001100000000001122222222222222222222222222222222222220000000001000000000001222222222222000000000002222222222222222222222222000000000001000000000001
100000000000100000000000000000000001100000000000110000000000000000000000100000000000000000000000100000000000000000000001100000000000000000000001100000000001100000000001100000000000000000000001100000000001000000000001000000000000000000000001000000000000000000000000000000000001000000000001000000000001
100000000000100000000000000000000001100000000000110000000000000000000000100000000000000000000000100000000000000000000001100000000000000000000001100000000001100000000001100000000000000000000001100000000001000000000221000000000000000000000001000000000000000000000000000000000001000000000001000000000001
100000000000100000000000222222222221100000000000112222222222222222222222122222222222200000000000122222222222222222222221100000000002200000000000000000000001100000000001100000000002200000000000000000000221000000000001000000000002000000000001000000000002222222222222000000000001000000000001000000000001
100000000000000000000000100000000000000000000000110000000000000000000000000000000000100000000000100000000000000000000000000000000001100000000000000000000001100000000001100000000001100000000000000000000001000000000001000000000001000000000001000000000000000000000001000000000001000000000001000000000001
100000000000000000000000100000000000000000000000110000000000000000000000000000000000100000000000100000000000000000000000000000000001100000000000000000000001100000000001100000000001100000000000000000000001220000000001000000000001000000000001000000000000000000000001000000000001000000000001000000000001
122222222222222222222222100000000000222222222222110000000000200000000000222222222222100000000000100000000002222222222222222222222221100000000002222222222221100000000001100000000001122222222222222222222221000000000001222222222221000000000001222222222222000000000001000000000001222222222221000000000001
100000000000000000000000000000000000000000000000000000000000100000000000000000000000000000000000000000000001100000000000000000000000000000000001100000000000000000000001100000000000000000000000000000000000000000000000000000000000000000000001000000000000000000000001000000000000000000000000000000000001
100000000000000000000000000000000000000000000000000000000000100000000000000000000000000000000000000000000001100000000000000000000000000000000001100000000000000000000001100000000000000000000000000000000000000000000000000000000000000000000001000000000000000000000001000000000000000000000000000000000001
122222222222222222222222222222222222222222222222222222222222122222222222222222222222222222222222222222222221122222222222222222222222222222222221100000000002222222222221122222222222222222222222222222222222222222222222222222222222222222222221222222222222222222222221222222222222222222222222222222222221
100000000000000000000000000000000000000000000000000000000000000000000000000000000000000000000000000000000000000000000000000000000000000000000000000000000000000000000000000000000000000000000000000000000000000000000000000000000000000000000000000000000000000000000000000000000000000000000000000000000001
100000000000000000000000000000000000000000000000000000000000000000000000000000000000000000000000000000000000000000000000000000000000000000000000000000000000000000000000000000000000000000000000000000000000000000000000000000000000000000000000000000000000000000000000000000000000000000000000000000000001
133333333333333333333333333333333333333333333333333333333333333333333333333333333333333333333333333333333333333333333333333333333333333333333333333333333333333333333333333333333333333333333333333333333333333333333333333333333333333333333333333333333333333333333333333333333333333333333333333333333331